* b * * * * * * * * * * * * *
* * * * * * * * * * * * * * *
* * * * * * * * * * * * * * *
* * * * * * * * * * * * * * *
* * * * sd sd sd sd * * * * * * *
* * * * b b b d * * * * * * *
* * * * b b b d * * * * * * *
* * * * b b b d d * * * * * *
* * * * b b b b b * * * * * *
* * * * b b b b b * * * * * *
* * * * b b b b b * * * * * *
* * * * * * * * * * * * * * *
* * * * * * * * * * * * * * *
* * * * * * * * * * * * * * *
* * * * * * * * * * * * * * e